0000000000000000
0000011111100000
0000012222100000
0000012111100000
5111112111100000
0000012111100000
0000012222100000
0000011111100000
0000000000000000