0000000000000000
0000000000000000
0110102001010111
0100101001100100
0110101001100100
0100101001100100
0100112101010111
0000000000000000
0000000000000000